Tworzenie procesu - CP nazwa rodzic* program**
Usuwanie procesu - DP nazwa
Wyswietlanie wszystkich procesów - PP
Wyswietlanie bloku kontrolnego procesu - BC nazwa
Wywolanie rozkazu programu - GO
Zawartosc pamieci od adresu - MC adres rozmiar
Ca³a zawartosc pamieci - MS
Tworzenie pliku - MF nazwa rozszerzenie folder*
Usuwanie pliku - DF nazwa rozszerzenie folder*
Zmiana nazwy pliku - RF nazwa rozszerzenie nowaNazwa folder*
Zapis do pliku - SF nazwa rozszerzenie dane folder*
Pobranie danych z pliku - PF nazwa rozszerzenie folder*
Otwieranie stratne - XF nazwa rozszerzenie folder*
Pobranie danych bez zamkniêcia - OF nazwa rozszerzenie folder*
Zamkniecie pliku - CF nazwa rozszerzenie folder*
Tworzenie folderu - MD nazwa nazwaNadrzednego*
Dodawanie pliku do katalogu - AD nazwaDocelowego nazwaPliku rozszerzenie nazwaFolderuZPlikiem*
Usuwanie folderu - DD nazwa
Szukanie folderu - FD nazwa
Wypisanie drzewa plikow i katalogow - PT
Wypisanie tablicy dyskowej - PD
Wypisanie wektora bitowego - PV
Wypisanie tablicy iwezlow - PN
Wypisanie tablicy wpisow - PX
Kolejka procesow gotowych - RQ
Kolejka procesow oczekujacych - WQ
Wczytywanie skryptu - LS nazwa
Przeniesienie potomkow procesu pod inny - MP nazwaZKtorego nazwaDoKtorego
Wyswietlanie bloczkow pamieci RAM - RB
Spis komend - help
